//MAP CONVERTED BY dmm2tgm.py THIS HEADER COMMENT PREVENTS RECONVERSION, DO NOT REMOVE
"a" = (
/turf/closed/indestructible/reinforced,
/area/deathmatch)
"c" = (
/turf/open/floor/fake_snow,
/area/deathmatch)
"e" = (
/obj/structure/statue/snow/snowman,
/obj/item/toy/balloon/syndicate{
	pixel_y = 11;
	pixel_x = 5
	},
/turf/open/floor/fake_snow,
/area/deathmatch)
"g" = (
/obj/machinery/light{
	dir = 4
	},
/turf/open/floor/carpet/neon,
/area/deathmatch)
"i" = (
/obj/structure/table/reinforced/plastitaniumglass,
/turf/open/floor/carpet/neon,
/area/deathmatch)
"o" = (
/obj/item/stack/medical/suture,
/turf/open/floor/fake_snow,
/area/deathmatch)
"p" = (
/obj/structure/barricade/wooden,
/turf/open/floor/carpet/neon,
/area/deathmatch)
"r" = (
/obj/machinery/light{
	dir = 8
	},
/obj/structure/barricade/wooden,
/turf/open/floor/carpet/neon,
/area/deathmatch)
"v" = (
/obj/structure/rack,
/turf/open/floor/carpet/neon,
/area/deathmatch)
"x" = (
/obj/effect/landmark/deathmatch_player_spawn,
/obj/effect/landmark/deathmatch_player_spawn,
/turf/open/floor/carpet/neon,
/area/deathmatch)
"z" = (
/obj/machinery/light{
	dir = 8
	},
/turf/open/floor/carpet/neon,
/area/deathmatch)
"A" = (
/obj/machinery/light{
	dir = 1
	},
/turf/open/floor/carpet/neon,
/area/deathmatch)
"B" = (
/obj/machinery/light{
	dir = 4
	},
/turf/open/floor/fakeice/slippery,
/area/deathmatch)
"C" = (
/obj/machinery/light{
	dir = 4
	},
/turf/open/chasm,
/area/deathmatch)
"D" = (
/turf/open/floor/fakeice/slippery,
/area/deathmatch)
"F" = (
/obj/structure/closet/crate/secure/science,
/obj/item/toy/plush/lizard_plushie/green,
/turf/open/floor/carpet/neon,
/area/deathmatch)
"K" = (
/obj/machinery/light{
	dir = 4
	},
/turf/open/floor/fake_snow,
/area/deathmatch)
"L" = (
/obj/machinery/light{
	dir = 8
	},
/turf/open/floor/fakeice/slippery,
/area/deathmatch)
"M" = (
/obj/machinery/door/airlock/freezer,
/obj/structure/barricade/wooden/crude,
/turf/open/floor/iron/freezer,
/area/deathmatch)
"O" = (
/obj/machinery/door/airlock/freezer,
/turf/open/floor/iron/freezer,
/area/deathmatch)
"P" = (
/obj/structure/table/reinforced/plastitaniumglass,
/obj/structure/table/reinforced/plastitaniumglass,
/turf/open/floor/carpet/neon,
/area/deathmatch)
"Q" = (
/obj/structure/rack,
/obj/item/reagent_containers/hypospray/medipen/stimulants,
/turf/open/floor/carpet/neon,
/area/deathmatch)
"R" = (
/obj/effect/landmark/deathmatch_player_spawn,
/turf/open/floor/carpet/neon,
/area/deathmatch)
"V" = (
/obj/structure/rack,
/obj/item/ammo_box/magazine/sniper_rounds/penetrator,
/turf/open/floor/carpet/neon,
/area/deathmatch)
"W" = (
/obj/structure/toilet{
	dir = 8
	},
/obj/machinery/light{
	dir = 4
	},
/turf/open/floor/iron/freezer,
/area/deathmatch)
"Y" = (
/turf/open/floor/carpet/neon,
/area/deathmatch)

(1,1,1) = {"
a
a
a
a
a
a
a
a
a
a
a
a
a
a
a
a
a
a
a
a
a
a
a
a
a
a
a
a
a
a
a
"}
(2,1,1) = {"
a
F
r
Y
p
Y
Y
Y
z
Y
Y
Y
p
Y
Y
Y
z
Y
Y
i
Y
Y
Y
Y
Y
Y
z
Y
Y
Y
a
"}
(3,1,1) = {"
a
p
Y
Y
i
Y
Y
Y
i
Y
Y
Y
p
Y
Y
Y
i
Y
Y
p
Y
Y
i
Y
Y
Y
Y
Y
Y
Y
a
"}
(4,1,1) = {"
a
Y
Y
Y
p
Y
Y
Y
i
Y
Y
Y
i
Y
Y
Y
i
Y
Y
p
Y
Y
i
Y
Y
Y
i
Y
i
i
a
"}
(5,1,1) = {"
a
i
i
Y
a
Y
Y
Y
p
Y
Y
Y
i
Y
Y
Y
p
Y
Y
a
Y
Y
a
Y
Y
Y
p
Y
Y
Y
a
"}
(6,1,1) = {"
a
Y
Y
Y
a
Y
R
Y
a
Y
Y
Y
R
Y
Y
Y
p
Y
Y
Y
Y
R
a
Y
Y
R
p
Y
Y
Y
a
"}
(7,1,1) = {"
a
a
p
i
a
i
i
p
a
a
i
i
p
p
i
i
a
a
i
i
i
p
a
i
i
p
a
a
p
a
a
"}
(8,1,1) = {"
a
Y
Y
Y
p
c
c
c
c
e
c
c
c
c
c
c
L
D
D
c
c
c
c
c
D
D
i
Y
Y
Y
a
"}
(9,1,1) = {"
a
A
Y
Y
i
c
c
D
D
c
o
D
D
D
c
D
D
D
D
D
D
c
D
D
D
D
i
Y
Y
v
a
"}
(10,1,1) = {"
a
V
Y
Y
i
D
D
D
D
D
D
D
D
D
D
D
D
c
D
D
D
D
D
D
D
c
a
A
Y
V
a
"}
(11,1,1) = {"
a
Q
Y
Y
p
D
D
c
K
D
D
c
c
D
D
c
c
c
c
c
D
D
B
c
c
c
p
Y
Y
Y
a
"}
(12,1,1) = {"
a
p
p
a
p
p
i
i
a
p
i
i
p
i
i
i
a
p
p
P
i
i
a
p
i
i
a
a
p
a
a
"}
(13,1,1) = {"
a
Y
Y
Y
Y
Y
x
Y
p
Y
Y
Y
R
Y
Y
Y
p
R
Y
Y
Y
Y
a
R
Y
Y
p
Y
Y
Y
a
"}
(14,1,1) = {"
a
Y
Y
Y
Y
Y
Y
Y
a
Y
Y
Y
Y
Y
Y
Y
a
Y
Y
Y
Y
Y
i
Y
Y
Y
p
p
i
Y
a
"}
(15,1,1) = {"
a
Y
Y
Y
a
Y
Y
Y
i
Y
Y
Y
a
Y
Y
Y
Y
Y
Y
Y
Y
Y
p
Y
Y
Y
i
Y
Y
Y
a
"}
(16,1,1) = {"
a
M
a
O
a
Y
Y
Y
i
Y
Y
Y
i
Y
Y
Y
g
Y
Y
i
Y
Y
Y
Y
Y
Y
g
Y
i
i
a
"}
(17,1,1) = {"
a
C
a
W
p
Y
Y
Y
g
Y
Y
Y
i
Y
Y
Y
a
Y
Y
i
Y
Y
Y
Y
Y
Y
a
Y
Y
Y
a
"}
(18,1,1) = {"
a
a
a
a
a
a
a
a
a
a
a
a
a
a
a
a
a
a
a
a
a
a
a
a
a
a
a
a
a
a
a
"}
