//MAP CONVERTED BY dmm2tgm.py THIS HEADER COMMENT PREVENTS RECONVERSION, DO NOT REMOVE
"aj" = (
/obj/effect/turf_decal/raven{
	dir = 8
	},
/obj/machinery/atmospherics/components/unary/portables_connector/visible{
	dir = 1
	},
/obj/machinery/portable_atmospherics/canister/air,
/obj/effect/turf_decal/stripes/corner{
	dir = 4
	},
/turf/open/floor/mineral/titanium/tiled,
/area/shuttle/escape)
"am" = (
/obj/effect/turf_decal/siding/yellow{
	dir = 4
	},
/obj/effect/turf_decal/siding/yellow{
	dir = 8
	},
/turf/open/floor/mineral/titanium/tiled/yellow,
/area/shuttle/escape)
"aS" = (
/obj/machinery/atmospherics/pipe/layer_manifold/dark/visible/layer2{
	dir = 4
	},
/obj/effect/mapping_helpers/airlock/access/all/science/ordnance,
/obj/machinery/door/airlock/research/glass/incinerator/ordmix_exterior{
	id_tag = "shuttleburnex"
	},
/turf/open/floor/engine,
/area/shuttle/escape)
"bQ" = (
/obj/machinery/status_display,
/turf/closed/wall/mineral/titanium,
/area/shuttle/escape)
"bV" = (
/turf/open/space/basic,
/area/shuttle/escape)
"cm" = (
/obj/effect/turf_decal/siding/purple,
/obj/effect/turf_decal/siding/purple/corner{
	dir = 1
	},
/obj/machinery/light,
/obj/effect/turf_decal/siding/purple{
	dir = 4
	},
/obj/effect/turf_decal/siding/purple/corner,
/turf/open/floor/mineral/titanium/tiled/purple,
/area/shuttle/escape)
"dl" = (
/obj/machinery/computer/rdconsole,
/obj/machinery/light{
	dir = 1
	},
/turf/open/floor/mineral/titanium/tiled/blue,
/area/shuttle/escape)
"dx" = (
/obj/machinery/door/airlock/science/glass,
/obj/effect/turf_decal/caution/stand_clear{
	dir = 4
	},
/turf/open/floor/iron/herringbone,
/area/shuttle/escape)
"dD" = (
/obj/effect/turf_decal/siding/purple{
	dir = 1
	},
/obj/effect/turf_decal/siding/purple,
/turf/open/floor/mineral/titanium/tiled/purple,
/area/shuttle/escape)
"dT" = (
/obj/structure/chair/comfy/shuttle{
	dir = 4
	},
/obj/structure/window/reinforced{
	dir = 8
	},
/turf/open/floor/mineral/titanium/tiled/white,
/area/shuttle/escape)
"dV" = (
/obj/structure/sign/poster/contraband/mothic_rations{
	desc = "A poster showing a commissary menu from the Mothic fleet flagship, the Va Lümla. It lists various consumable items alongside prices in ration tickets. You can see handwritten notes and check marks over some items."
	},
/turf/closed/wall/mineral/titanium,
/area/shuttle/escape)
"eD" = (
/obj/effect/turf_decal/siding/purple{
	dir = 1
	},
/obj/effect/turf_decal/siding/purple,
/obj/machinery/light{
	dir = 1
	},
/turf/open/floor/mineral/titanium/tiled/purple,
/area/shuttle/escape)
"gh" = (
/obj/effect/turf_decal/siding/yellow/end,
/obj/effect/turf_decal/siding/yellow/corner{
	dir = 8
	},
/obj/effect/turf_decal/siding/yellow/corner,
/turf/open/floor/mineral/titanium/tiled/yellow,
/area/shuttle/escape)
"gs" = (
/obj/effect/turf_decal/siding/purple,
/obj/machinery/light,
/obj/effect/turf_decal/siding/purple{
	dir = 8
	},
/obj/effect/turf_decal/siding/purple/corner{
	dir = 8
	},
/turf/open/floor/mineral/titanium/tiled/purple,
/area/shuttle/escape)
"gR" = (
/obj/machinery/door/airlock/command/glass{
	name = "Escape Shuttle Cockpit"
	},
/turf/open/floor/mineral/titanium/blue,
/area/shuttle/escape)
"hn" = (
/obj/structure/table/reinforced,
/obj/effect/spawner/random/bureaucracy/folder,
/obj/item/pen,
/obj/item/pen/blue,
/obj/machinery/light,
/turf/open/floor/mineral/titanium/tiled/blue,
/area/shuttle/escape)
"hr" = (
/obj/effect/turf_decal/siding/purple{
	dir = 4
	},
/obj/effect/turf_decal/siding/purple{
	dir = 8
	},
/turf/open/floor/mineral/titanium/tiled/purple,
/area/shuttle/escape)
"hQ" = (
/obj/machinery/computer/apc_control,
/turf/open/floor/mineral/titanium/tiled/blue,
/area/shuttle/escape)
"hZ" = (
/obj/effect/turf_decal/siding/purple,
/obj/effect/turf_decal/siding/purple{
	dir = 1
	},
/turf/open/floor/mineral/titanium/tiled/purple,
/area/shuttle/escape)
"iC" = (
/obj/machinery/door/airlock/external/glass,
/obj/effect/turf_decal/siding/white,
/turf/open/floor/mineral/titanium/tiled/white,
/area/shuttle/escape)
"iU" = (
/obj/structure/window/reinforced/spawner,
/obj/structure/window/reinforced/spawner{
	dir = 4
	},
/obj/machinery/power/shuttle_engine/heater{
	dir = 8
	},
/turf/open/floor/plating,
/area/shuttle/escape)
"jv" = (
/obj/machinery/airlock_controller/incinerator_ordmix{
	id_tag = "shuttleaircon";
	sensor_tag = "shuttleairsen";
	airpump_tag = "shuttlepump";
	interior_door_tag = "shuttleburnin";
	exterior_door_tag = "shuttleburnex"
	},
/turf/closed/wall/r_wall,
/area/shuttle/escape)
"jC" = (
/obj/effect/turf_decal/siding/purple{
	dir = 1
	},
/obj/effect/turf_decal/siding/purple/corner{
	dir = 8
	},
/obj/effect/turf_decal/siding/purple{
	dir = 4
	},
/obj/effect/turf_decal/siding/purple/corner{
	dir = 4
	},
/turf/open/floor/mineral/titanium/tiled/purple,
/area/shuttle/escape)
"jI" = (
/obj/machinery/research/anomaly_refinery,
/turf/open/floor/mineral/titanium/tiled,
/area/shuttle/escape)
"jX" = (
/obj/machinery/portable_atmospherics/canister/plasma,
/obj/structure/window/reinforced{
	dir = 8
	},
/turf/open/floor/mineral/titanium/tiled/white,
/area/shuttle/escape)
"kY" = (
/obj/machinery/light{
	dir = 4
	},
/obj/effect/turf_decal/raven{
	dir = 8
	},
/obj/effect/turf_decal/raven{
	dir = 4
	},
/obj/effect/turf_decal/raven{
	dir = 4
	},
/turf/open/floor/mineral/titanium/tiled,
/area/shuttle/escape)
"ln" = (
/obj/machinery/computer/crew{
	dir = 1
	},
/turf/open/floor/mineral/titanium/tiled/blue,
/area/shuttle/escape)
"lt" = (
/obj/machinery/atmospherics/pipe/smart/simple/pink/visible,
/turf/closed/wall/r_wall,
/area/shuttle/escape)
"lE" = (
/obj/machinery/computer/atmos_alert{
	dir = 1
	},
/obj/machinery/light,
/turf/open/floor/mineral/titanium/tiled/blue,
/area/shuttle/escape)
"lN" = (
/obj/structure/window/reinforced/fulltile,
/turf/closed/indestructible/grille,
/area/shuttle/escape)
"mg" = (
/obj/machinery/computer/communications{
	dir = 8
	},
/turf/open/floor/mineral/titanium/tiled/blue,
/area/shuttle/escape)
"nk" = (
/obj/structure/chair/comfy/shuttle,
/turf/open/floor/mineral/titanium/tiled/blue,
/area/shuttle/escape)
"nm" = (
/obj/effect/turf_decal/loading_area,
/obj/effect/turf_decal/raven,
/obj/effect/turf_decal/stripes/corner{
	dir = 1
	},
/obj/machinery/atmospherics/pipe/smart/simple/supply/visible{
	dir = 4
	},
/turf/open/floor/mineral/titanium/tiled,
/area/shuttle/escape)
"nr" = (
/obj/machinery/atmospherics/pipe/layer_manifold/dark/visible{
	dir = 4
	},
/obj/structure/sign/warning/directional/south,
/obj/machinery/atmospherics/pipe/bridge_pipe/supply/visible,
/turf/open/floor/mineral/titanium/tiled,
/area/shuttle/escape)
"nz" = (
/obj/structure/window/reinforced{
	dir = 4
	},
/obj/machinery/atmospherics/components/unary/thermomachine,
/obj/machinery/light{
	dir = 1
	},
/turf/open/floor/mineral/titanium/tiled,
/area/shuttle/escape)
"nS" = (
/obj/structure/chair/comfy/shuttle{
	dir = 4
	},
/obj/structure/window/reinforced{
	dir = 8
	},
/obj/machinery/airlock_controller/incinerator_ordmix{
	id_tag = "shuttleaircon";
	sensor_tag = "shuttleairsen";
	airpump_tag = "shuttlepump";
	interior_door_tag = "shuttleburnin";
	exterior_door_tag = "shuttleburnex"
	},
/turf/open/floor/mineral/titanium/tiled/white,
/area/shuttle/escape)
"nW" = (
/obj/machinery/atmospherics/components/trinary/mixer/layer4{
	dir = 8
	},
/obj/structure/sign/warning/radiation/directional/south,
/turf/open/floor/mineral/titanium/tiled,
/area/shuttle/escape)
"of" = (
/obj/machinery/door/poddoor/incinerator_ordmix{
	id = "shuttlemixvent'"
	},
/turf/open/floor/plating/airless,
/area/shuttle/escape)
"or" = (
/obj/machinery/atmospherics/components/binary/pump/on/scrubbers/visible/layer2{
	dir = 8
	},
/obj/machinery/atmospherics/components/binary/pump/on/dark/visible/layer4{
	dir = 4
	},
/turf/open/floor/mineral/plastitanium,
/area/shuttle/escape)
"pA" = (
/obj/effect/turf_decal/siding/purple{
	dir = 8
	},
/turf/open/floor/mineral/titanium/tiled/purple,
/area/shuttle/escape)
"qQ" = (
/obj/machinery/atmospherics/pipe/smart/simple/scrubbers/visible/layer2{
	dir = 5
	},
/obj/machinery/atmospherics/pipe/smart/simple/dark/visible/layer4{
	dir = 5
	},
/obj/effect/turf_decal/caution/stand_clear{
	dir = 8
	},
/turf/open/floor/mineral/titanium/tiled,
/area/shuttle/escape)
"qV" = (
/obj/machinery/portable_atmospherics/canister/oxygen,
/turf/open/floor/mineral/titanium/tiled/white,
/area/shuttle/escape)
"rV" = (
/obj/machinery/light,
/obj/machinery/atmospherics/components/tank/oxygen{
	dir = 8
	},
/turf/open/floor/mineral/titanium/tiled,
/area/shuttle/escape)
"sm" = (
/obj/machinery/atmospherics/pipe/smart/simple/scrubbers/visible/layer2{
	dir = 4
	},
/obj/machinery/atmospherics/components/unary/outlet_injector/monitored/ordnance_burn_chamber_input{
	dir = 8;
	chamber_id = "shuttleburn"
	},
/turf/open/floor/engine,
/area/shuttle/escape)
"so" = (
/obj/effect/turf_decal/raven{
	dir = 1
	},
/obj/effect/turf_decal/raven,
/obj/machinery/atmospherics/pipe/smart/simple/supply/visible{
	dir = 4
	},
/turf/open/floor/mineral/titanium/tiled,
/area/shuttle/escape)
"sp" = (
/turf/open/floor/mineral/titanium/tiled/blue,
/area/shuttle/escape)
"sT" = (
/obj/machinery/portable_atmospherics/scrubber,
/obj/machinery/door/window/left/directional/south,
/turf/open/floor/mineral/titanium/white,
/area/shuttle/escape)
"sW" = (
/obj/machinery/atmospherics/components/unary/passive_vent{
	dir = 1
	},
/obj/structure/window/reinforced{
	dir = 8
	},
/obj/structure/window/reinforced{
	dir = 4
	},
/turf/open/floor/plating/airless,
/area/shuttle/escape)
"tx" = (
/obj/machinery/portable_atmospherics/canister/plasma,
/obj/structure/window/reinforced{
	dir = 4
	},
/obj/machinery/light{
	dir = 1
	},
/turf/open/floor/mineral/titanium/tiled/white,
/area/shuttle/escape)
"ux" = (
/obj/structure/chair/comfy/shuttle{
	dir = 8
	},
/obj/structure/window/reinforced{
	dir = 4
	},
/turf/open/floor/mineral/titanium/tiled/white,
/area/shuttle/escape)
"uM" = (
/obj/machinery/atmospherics/pipe/smart/simple/scrubbers/visible/layer2{
	dir = 8
	},
/obj/machinery/atmospherics/pipe/smart/simple/dark/visible/layer4{
	dir = 8
	},
/obj/effect/mapping_helpers/airlock/access/all/science/ordnance,
/obj/machinery/door/airlock/research/glass/incinerator/ordmix_interior{
	id_tag = "shuttleburnin"
	},
/turf/open/floor/mineral/plastitanium,
/area/shuttle/escape)
"uT" = (
/obj/effect/turf_decal/siding/purple{
	dir = 8
	},
/obj/effect/turf_decal/siding/purple{
	dir = 4
	},
/turf/open/floor/mineral/titanium/tiled/purple,
/area/shuttle/escape)
"vO" = (
/obj/machinery/atmospherics/components/tank/oxygen{
	dir = 8
	},
/turf/open/floor/mineral/titanium/tiled,
/area/shuttle/escape)
"wi" = (
/obj/machinery/atmospherics/pipe/smart/simple/scrubbers/visible/layer2{
	dir = 4
	},
/obj/effect/decal/remains/human,
/obj/effect/decal/cleanable/ash,
/turf/open/floor/engine,
/area/shuttle/escape)
"wK" = (
/obj/machinery/atmospherics/components/trinary/mixer/layer4{
	dir = 8
	},
/obj/machinery/light,
/obj/machinery/atmospherics/pipe/smart/simple/dark/visible{
	dir = 5
	},
/turf/open/floor/mineral/titanium/tiled,
/area/shuttle/escape)
"yL" = (
/obj/effect/spawner/structure/window/reinforced,
/turf/open/floor/mineral/titanium/tiled/white,
/area/shuttle/escape)
"yM" = (
/obj/effect/turf_decal/siding/purple,
/obj/effect/turf_decal/siding/purple/corner{
	dir = 1
	},
/obj/effect/turf_decal/siding/purple/corner{
	dir = 4
	},
/obj/machinery/light,
/turf/open/floor/mineral/titanium/tiled/purple,
/area/shuttle/escape)
"yP" = (
/turf/closed/wall/r_wall,
/area/shuttle/escape)
"zg" = (
/obj/machinery/portable_atmospherics/canister/plasma,
/obj/structure/window/reinforced{
	dir = 8
	},
/obj/effect/mapping_helpers/airlock/access/all/science/ordnance_storage,
/obj/machinery/door/window/brigdoor/left{
	name = "Secure Plasma Storage";
	req_access = "ordnance"
	},
/turf/open/floor/mineral/titanium/tiled/white,
/area/shuttle/escape)
"zv" = (
/obj/effect/turf_decal/siding/purple{
	dir = 1
	},
/obj/effect/turf_decal/siding/purple{
	dir = 8
	},
/obj/effect/turf_decal/siding/purple/corner{
	dir = 1
	},
/turf/open/floor/mineral/titanium/tiled/purple,
/area/shuttle/escape)
"zy" = (
/obj/machinery/atmospherics/pipe/smart/simple/scrubbers/visible/layer2{
	dir = 4
	},
/turf/closed/wall/r_wall,
/area/shuttle/escape)
"Am" = (
/obj/structure/table/reinforced,
/obj/item/restraints/handcuffs,
/obj/item/restraints/handcuffs,
/obj/item/restraints/handcuffs,
/obj/item/storage/fancy/donut_box,
/obj/machinery/light,
/turf/open/floor/mineral/titanium/tiled/blue,
/area/shuttle/escape)
"Ax" = (
/obj/structure/chair/comfy/shuttle{
	dir = 1
	},
/turf/open/floor/mineral/titanium/tiled/blue,
/area/shuttle/escape)
"AB" = (
/obj/effect/turf_decal/stripes/corner{
	dir = 4
	},
/obj/effect/turf_decal/stripes/corner,
/obj/machinery/atmospherics/pipe/layer_manifold/scrubbers/visible/layer2,
/turf/open/floor/mineral/titanium/tiled,
/area/shuttle/escape)
"Cw" = (
/obj/effect/turf_decal/siding/purple{
	dir = 1
	},
/obj/effect/turf_decal/siding/purple/corner,
/obj/effect/turf_decal/siding/purple/corner{
	dir = 8
	},
/turf/open/floor/mineral/titanium/tiled/purple,
/area/shuttle/escape)
"Cy" = (
/obj/effect/turf_decal/siding/yellow/end{
	dir = 1
	},
/obj/effect/turf_decal/siding/yellow/corner{
	dir = 1
	},
/obj/effect/turf_decal/siding/yellow/corner{
	dir = 4
	},
/turf/open/floor/mineral/titanium/tiled/yellow,
/area/shuttle/escape)
"DG" = (
/obj/machinery/atmospherics/pipe/smart/simple/scrubbers/visible/layer2{
	dir = 1
	},
/obj/machinery/atmospherics/pipe/smart/simple/dark/visible/layer4{
	dir = 7
	},
/obj/effect/turf_decal/bot,
/obj/machinery/light{
	dir = 4
	},
/obj/machinery/computer/atmos_control/ordnancemix{
	atmos_chambers = list("shuttleburn"="Emergency Burn Chamberr";
	name = "Emergency Shuttle Chamber Control";
	dir = 8
	},
/turf/open/floor/mineral/titanium/tiled,
/area/shuttle/escape)
"Gg" = (
/obj/machinery/atmospherics/pipe/smart/simple/scrubbers/visible/layer2{
	dir = 10
	},
/obj/machinery/atmospherics/pipe/smart/simple/dark/visible/layer4{
	dir = 8
	},
/obj/structure/sign/warning/fire/directional/north,
/obj/machinery/atmospherics/components/binary/dp_vent_pump/high_volume/incinerator_ordmix{
	id_tag = "shuttlepump"
	},
/turf/open/floor/mineral/plastitanium,
/area/shuttle/escape)
"Gj" = (
/turf/closed/wall/mineral/titanium,
/area/shuttle/escape)
"GF" = (
/obj/machinery/portable_atmospherics/canister/nitrous_oxide,
/turf/open/floor/mineral/titanium/tiled/white,
/area/shuttle/escape)
"IT" = (
/obj/machinery/portable_atmospherics/canister/oxygen,
/obj/effect/decal/cleanable/fuel_pool,
/turf/open/floor/mineral/titanium/tiled/white,
/area/shuttle/escape)
"Jk" = (
/turf/open/space/basic,
/area/space)
"Jw" = (
/obj/structure/table/reinforced,
/obj/item/storage/toolbox/emergency,
/obj/item/radio,
/obj/item/radio,
/obj/item/radio,
/obj/machinery/light{
	dir = 1
	},
/turf/open/floor/mineral/titanium/tiled/blue,
/area/shuttle/escape)
"JO" = (
/obj/machinery/atmospherics/components/unary/portables_connector/visible/layer4,
/obj/effect/turf_decal/box,
/obj/machinery/atmospherics/pipe/smart/simple/scrubbers/visible/layer2{
	dir = 4
	},
/turf/open/floor/mineral/titanium/tiled,
/area/shuttle/escape)
"JR" = (
/obj/machinery/power/shuttle_engine/propulsion{
	dir = 8
	},
/turf/open/space/basic,
/area/shuttle/escape)
"KY" = (
/obj/machinery/airalarm/all_access{
	dir = 4;
	pixel_x = 24
	},
/obj/machinery/atmospherics/components/trinary/filter/layer2{
	dir = 8
	},
/obj/machinery/atmospherics/pipe/smart/simple/pink/visible,
/turf/open/floor/mineral/plastitanium,
/area/shuttle/escape)
"Lr" = (
/obj/machinery/portable_atmospherics/pump,
/obj/machinery/door/window/right/directional/south,
/obj/effect/turf_decal/stripes/corner,
/obj/structure/sign/warning/no_smoking/circle/directional/east,
/turf/open/floor/mineral/titanium/white,
/area/shuttle/escape)
"Lv" = (
/obj/machinery/computer/emergency_shuttle{
	dir = 8
	},
/turf/open/floor/mineral/titanium/tiled/blue,
/area/shuttle/escape)
"LE" = (
/obj/structure/chair/comfy/shuttle{
	dir = 4
	},
/turf/open/floor/mineral/titanium/tiled/blue,
/area/shuttle/escape)
"Mf" = (
/obj/effect/turf_decal/loading_area,
/obj/effect/turf_decal/stripes/corner{
	dir = 8
	},
/obj/machinery/atmospherics/pipe/smart/simple/supply/visible{
	dir = 10
	},
/obj/effect/decal/cleanable/fuel_pool,
/obj/effect/turf_decal/raven{
	dir = 4
	},
/turf/open/floor/mineral/titanium/tiled,
/area/shuttle/escape)
"Mg" = (
/obj/structure/table/reinforced,
/obj/item/transfer_valve{
	pixel_x = 5
	},
/obj/item/transfer_valve{
	pixel_x = 5
	},
/obj/item/transfer_valve,
/obj/item/transfer_valve{
	pixel_x = -5
	},
/obj/item/transfer_valve{
	pixel_x = -5
	},
/turf/open/floor/mineral/titanium/tiled,
/area/shuttle/escape)
"MT" = (
/obj/machinery/atmospherics/components/unary/vent_scrubber/on/layer2,
/obj/machinery/igniter/incinerator_ordmix{
	id = "shuttleign"
	},
/turf/open/floor/engine,
/area/shuttle/escape)
"Nd" = (
/obj/machinery/atmospherics/components/unary/vent_scrubber/on/layer2,
/turf/open/floor/engine,
/area/shuttle/escape)
"Nj" = (
/obj/machinery/atmospherics/pipe/smart/simple/supply/visible{
	dir = 7
	},
/turf/closed/wall/r_wall,
/area/shuttle/escape)
"Ny" = (
/obj/structure/window/reinforced/spawner{
	dir = 4
	},
/obj/machinery/power/shuttle_engine/heater{
	dir = 8
	},
/turf/open/floor/plating,
/area/shuttle/escape)
"NA" = (
/obj/machinery/atmospherics/pipe/smart/simple/scrubbers/visible/layer2{
	dir = 4
	},
/obj/machinery/atmospherics/pipe/smart/simple/dark/visible{
	dir = 5
	},
/obj/machinery/air_sensor/ordnance_burn_chamber{
	chamber_id = "shuttleburn";
	name = "Emergency Shuttle Burn Sensor"
	},
/turf/open/floor/engine,
/area/shuttle/escape)
"NB" = (
/obj/machinery/atmospherics/components/unary/portables_connector/visible/layer2{
	dir = 4
	},
/obj/machinery/light{
	dir = 8
	},
/obj/machinery/airlock_sensor/incinerator_ordmix{
	pixel_x = -24;
	id_tag = "shuttleairsen";
	master_tag = "shuttleaircon"
	},
/turf/open/floor/mineral/plastitanium,
/area/shuttle/escape)
"NN" = (
/obj/effect/turf_decal/raven{
	dir = 1
	},
/obj/effect/turf_decal/raven,
/turf/open/floor/mineral/titanium/tiled,
/area/shuttle/escape)
"NR" = (
/obj/machinery/portable_atmospherics/canister/plasma,
/obj/structure/window/reinforced{
	dir = 4
	},
/obj/effect/mapping_helpers/airlock/access/all/science/ordnance_storage,
/obj/machinery/door/window/brigdoor/right{
	req_access = "ordnance"
	},
/turf/open/floor/mineral/titanium/tiled/white,
/area/shuttle/escape)
"NY" = (
/obj/machinery/button/ignition/incinerator/ordmix{
	id = "shuttleign"
	},
/turf/closed/wall/r_wall,
/area/shuttle/escape)
"Oq" = (
/obj/machinery/atmospherics/pipe/smart/simple/scrubbers/visible/layer2{
	dir = 1
	},
/obj/machinery/atmospherics/pipe/smart/simple/dark/visible/layer4{
	dir = 6
	},
/obj/machinery/meter/layer4,
/turf/open/floor/mineral/titanium/tiled,
/area/shuttle/escape)
"Oy" = (
/obj/structure/table/reinforced,
/turf/open/floor/mineral/titanium/tiled/blue,
/area/shuttle/escape)
"PQ" = (
/obj/effect/turf_decal/box,
/obj/machinery/atmospherics/pipe/smart/manifold/scrubbers/visible/layer2{
	dir = 8
	},
/obj/machinery/meter/layer2,
/obj/machinery/atmospherics/components/unary/portables_connector/visible{
	dir = 1
	},
/turf/open/floor/mineral/titanium/tiled/airless,
/area/shuttle/escape)
"QH" = (
/obj/structure/table/reinforced,
/obj/item/assembly/signaler,
/obj/item/assembly/signaler{
	pixel_x = 6;
	pixel_y = 5
	},
/obj/item/assembly/signaler{
	pixel_x = -8;
	pixel_y = 5
	},
/obj/item/assembly/signaler{
	pixel_y = 8
	},
/turf/open/floor/mineral/titanium/tiled,
/area/shuttle/escape)
"QZ" = (
/obj/structure/tank_dispenser,
/turf/open/floor/mineral/titanium/white,
/area/shuttle/escape)
"RD" = (
/obj/effect/spawner/structure/window/reinforced/shuttle,
/turf/open/floor/plating,
/area/shuttle/escape)
"RS" = (
/obj/effect/spawner/structure/window/reinforced/plasma,
/turf/open/floor/mineral/titanium/tiled,
/area/shuttle/escape)
"SY" = (
/obj/machinery/portable_atmospherics/canister/nitrogen,
/obj/structure/sign/flag/mothic/directional/north,
/turf/open/floor/mineral/titanium/tiled/white,
/area/shuttle/escape)
"UR" = (
/obj/machinery/door/airlock/external/glass,
/obj/effect/turf_decal/siding/white,
/obj/docking_port/mobile/emergency{
	dir = 2
	},
/turf/open/floor/mineral/titanium/tiled/white,
/area/shuttle/escape)
"Vx" = (
/obj/structure/table/reinforced,
/obj/item/storage/medkit/emergency,
/obj/item/storage/medkit/emergency,
/obj/item/storage/medkit/emergency,
/obj/machinery/light{
	dir = 1
	},
/turf/open/floor/mineral/titanium/tiled/blue,
/area/shuttle/escape)
"Wg" = (
/obj/structure/window/reinforced/spawner{
	dir = 4
	},
/obj/structure/window/reinforced/spawner{
	dir = 1
	},
/obj/machinery/power/shuttle_engine/heater{
	dir = 8
	},
/turf/open/floor/plating,
/area/shuttle/escape)
"Wn" = (
/obj/machinery/portable_atmospherics/canister/nitrous_oxide,
/obj/machinery/light{
	dir = 1
	},
/turf/open/floor/mineral/titanium/tiled/white,
/area/shuttle/escape)
"WO" = (
/obj/effect/spawner/structure/window/reinforced,
/turf/closed/indestructible/grille,
/area/shuttle/escape)
"XS" = (
/obj/effect/turf_decal/raven{
	dir = 1
	},
/obj/effect/turf_decal/raven,
/obj/machinery/atmospherics/pipe/smart/simple/supply/visible{
	dir = 6
	},
/turf/open/floor/mineral/titanium/tiled,
/area/shuttle/escape)
"Yh" = (
/obj/structure/fireaxecabinet,
/turf/closed/wall/mineral/titanium,
/area/shuttle/escape)
"YO" = (
/obj/machinery/atmospherics/components/unary/vent_scrubber/on/layer2,
/obj/machinery/atmospherics/pipe/smart/simple/dark/visible{
	dir = 10
	},
/turf/open/floor/engine,
/area/shuttle/escape)
"YP" = (
/obj/machinery/power/shuttle_engine/large{
	dir = 8
	},
/turf/open/space/basic,
/area/shuttle/escape)
"Zl" = (
/obj/machinery/atmospherics/components/unary/portables_connector/visible/layer2{
	dir = 8
	},
/obj/machinery/portable_atmospherics/canister,
/obj/machinery/atmospherics/pipe/bridge_pipe/supply/visible,
/turf/open/floor/mineral/titanium/tiled,
/area/shuttle/escape)
"Zr" = (
/obj/machinery/portable_atmospherics/canister/nitrogen,
/turf/open/floor/mineral/titanium/tiled/white,
/area/shuttle/escape)
"Zw" = (
/obj/machinery/button/door/directional/east{
	id = "shuttlemixvent"
	},
/obj/structure/sign/warning/doors/directional/south,
/obj/machinery/light{
	dir = 4
	},
/turf/open/floor/mineral/titanium/tiled,
/area/shuttle/escape)
"ZO" = (
/obj/machinery/light{
	dir = 4
	},
/obj/structure/tank_dispenser,
/turf/open/floor/mineral/titanium/white,
/area/shuttle/escape)

(1,1,1) = {"
bV
YP
Jk
Jk
Jk
Jk
Jk
Jk
bV
YP
Jk
"}
(2,1,1) = {"
bV
bV
JR
JR
JR
JR
JR
JR
bV
bV
Jk
"}
(3,1,1) = {"
Wg
Ny
Ny
Ny
Ny
Ny
Ny
Ny
Ny
iU
Jk
"}
(4,1,1) = {"
Gj
WO
WO
WO
WO
WO
WO
WO
WO
Gj
Jk
"}
(5,1,1) = {"
Gj
Cy
am
am
am
am
am
am
gh
Gj
Jk
"}
(6,1,1) = {"
Gj
dV
nz
AB
PQ
Oq
DG
qQ
Zw
yP
Jk
"}
(7,1,1) = {"
Gj
Wn
GF
NN
JO
wK
jv
uM
NY
yP
Jk
"}
(8,1,1) = {"
Gj
SY
Zr
NN
JO
nW
yP
or
NB
yP
Jk
"}
(9,1,1) = {"
Gj
IT
qV
XS
Zl
nr
Nj
Gg
KY
lt
sW
"}
(10,1,1) = {"
Gj
jX
zg
so
QH
rV
yP
aS
zy
yP
Jk
"}
(11,1,1) = {"
Gj
tx
NR
so
Mg
vO
RS
YO
NA
of
Jk
"}
(12,1,1) = {"
Gj
QZ
sT
nm
jI
vO
RS
Nd
sm
of
Jk
"}
(13,1,1) = {"
Gj
ZO
Lr
Mf
kY
aj
RS
MT
wi
of
Jk
"}
(14,1,1) = {"
Gj
Gj
Gj
dx
dx
Gj
yP
yP
yP
yP
Jk
"}
(15,1,1) = {"
iC
Cy
am
am
am
am
am
am
gh
bQ
Jk
"}
(16,1,1) = {"
Gj
zv
pA
pA
pA
pA
pA
pA
gs
yL
Jk
"}
(17,1,1) = {"
iC
eD
ux
ux
ux
ux
ux
ux
hZ
yL
Jk
"}
(18,1,1) = {"
yL
dD
dT
dT
dT
dT
dT
dT
hZ
bQ
Jk
"}
(19,1,1) = {"
yL
Cw
hr
hr
hr
hr
hr
hr
yM
yL
Jk
"}
(20,1,1) = {"
Gj
dD
ux
ux
ux
ux
ux
ux
hZ
yL
Jk
"}
(21,1,1) = {"
yL
eD
dT
dT
dT
dT
dT
dT
hZ
bQ
Jk
"}
(22,1,1) = {"
yL
Cw
hr
hr
hr
hr
hr
hr
yM
yL
Jk
"}
(23,1,1) = {"
UR
dD
ux
ux
ux
ux
ux
ux
hZ
yL
Jk
"}
(24,1,1) = {"
Gj
dD
dT
dT
dT
nS
dT
dT
dD
bQ
Jk
"}
(25,1,1) = {"
iC
jC
uT
uT
uT
uT
uT
uT
cm
yP
Jk
"}
(26,1,1) = {"
Gj
Gj
Yh
lN
gR
gR
lN
Gj
Gj
Gj
Jk
"}
(27,1,1) = {"
Jk
Gj
dl
Ax
sp
sp
nk
lE
Gj
Jk
Jk
"}
(28,1,1) = {"
Jk
Gj
hQ
Ax
sp
sp
nk
ln
Gj
Jk
Jk
"}
(29,1,1) = {"
Jk
bQ
Vx
Oy
LE
LE
Oy
hn
bQ
Jk
Jk
"}
(30,1,1) = {"
Jk
Gj
Gj
Jw
mg
Lv
Am
Gj
Gj
Jk
Jk
"}
(31,1,1) = {"
Jk
Jk
Gj
RD
RD
RD
RD
Gj
Jk
Jk
Jk
"}
